Cuenta,Fecha,Hora,Sucursal,Descripci�n,Cargo/Abono,Importe,Saldo,Referencia,Concepto,Banco Participante,Clabe Beneficiario,Nombre Beneficiario,Cta Ordenante,Nombre Ordenante,C�digo Devoluci�n,Causa Devoluci�n,RFC Beneficiario,RFC Ordenante,Clave de Rastreo
12345678901     ,'06012020',0242,0560,COM MEM E-PYM                           ,-,650.00,67705.02,00000000,                   DIC 2019                                                               ,                                        ,                    ,                                        ,                    ,                                        ,  ,                              ,               ,               ,
12345678901     ,'01012020',0242,0560,IVA COMISION                            ,-,104.00,67601.02,00000000,                   DIC 2019                                                               ,                                        ,                    ,                                        ,                    ,                                        ,  ,                              ,               ,               ,
12345678901     ,'00012020',1301,7465,AB TRANSF SPEI                          ,+,400.00,68001.02,005350440,STELLA 2549 ENERO 2020                   012150029931129267                               ,"BBVA BANCOMER, S.A.                     ",56789010141501234  ,COMITE HACIENDA VICTORIA AC            ,112926701215002993  ,PEDRO CECILIO CHAVEZ PEREZ        ,  ,                              ,223SP0CST160   ,9IQMA061TY86   ,MBAN00004813113100200102
12345678901     ,'09012020',1340,3597,AB TRANS ELECT                          ,+,400.00,68401.02,009222775,Mto Enero 2020 Stella 2586                                                                ,                                        ,                    ,                                        ,                    ,                                        ,  ,                              ,               ,               ,
12345678901     ,'07012020',1418,3597,AB TRANS ELECT                          ,+,400.00,68801.02,003859279,Stella 2545 enero                                                                         ,                                        ,                    ,                                        ,                    ,                                        ,  ,                              ,               ,               ,
12345678901     ,'04012020',1451,7465,AB TRANSF SPEI                          ,+,400.00,69201.02,005368355,STELLA2706ENERO2020                      012150029946498501                               ,"BBVA BANCOMER, S.A.                     ",45678901014150123  ,COMITE HACIENDA VICTORIA AC            ,464985010121500299  ,ARTURO FRANCISCO REYNA GONZALEZ                      ,  ,                              ,SP0C60223ST1   ,0406UNGUPJ83   ,MBAN20004839103010020010
12345678901     ,'07012020',1805,7465,AB TRANSF SPEI                          ,+,2730.00,71931.02,005398903,STELLA 2502                              012150027371209587                               ,"BBVA BANCOMER, S.A.                     ",45678901014150123  ,COMITE HACIENDA VICTORIA AC            ,120958701215002737  ,ESTER DE LA CRUZ MARTINEZ               ,  ,                              ,223SP0CST160   ,60910D4TEEJ8   ,MBAN48827950100200102000
12345678901     ,'06012020',2328,7465,AB TRANSF SPEI                          ,+,380.00,72311.02,005441742,STELLA 2531 ENERO 2020                   012150028674592628                               ,"BBVA BANCOMER, S.A.                     ",34567890101415012  ,COMITE HACIENDA VICTORIA AC            ,459262801215002867  ,ANTUAN DE LA O PALMA                     ,  ,                              ,223SP0CST160   ,01014MSMEFM6   ,MBAN00494449410020010200
12345678901     ,'03012020',0831,7465,AB TRANSF SPEI                          ,+,400.00,72711.02,005963316,Mtto Enero 2020 Luminosita 2516          044150256006835081                               ,SCOTIA BANK INVERLAT                    ,45678901014150123  ,COMITE HACIENDA VICTORIA AC            ,683508104415025600  ,PRICILA ECHAVARRIA REYNAGA          ,  ,                              ,0223SP0CST16   ,90314IFDOBA6   ,2020010240044B36L1950000024812